1111111111
1.....2..1
2.21...1.1
1 211111 1
2        1
1  2221111
12 1  1  1
12 21 1 21
1        1
1112221111