33333335555333
2       8    2
2111    522922
2    *       1
2B        3311
2  44       s1
2  P4   B    1
11 11111111111
4            1
44444444444444