33333333333333
2     t      2
2111     P2222
2    *    g111
2B        1111
2  44       s1
2  P4   B    1
11 11111111111
4            1
44444444444444