1111411111
1      1 1
1121111111
1g 4P1s1t1
1        1
1     1111
1       B1
1     B221
1 *   P1 1
1     44 1
1     P  1
1        1
1        1
1        1
1142221111