33333335555555
2 P  s  8P  g5
2111    555955
2    *       1
2         3311
2  44 t     s1
2  P4     P  1
11 222    1111
4  g        B1
4    3       1
4  333    3331
4  B       P 1
4 s    33 t  1
44444444444444