3333322225555511111111999999999
2 P  s  %P  g5                1
2777   P555#55                1
2    *   s  B1                1
2         66112222222  88888888
2  44 t     s1                1
2  P4     P  1                1
11 222B   111133333333  7777777
4  g        B1                1
4    3   s   1                1
4  333    333144444444  6666666
4  B       P                  1
4 s    33 t  1                1
4444444444444455555555666666666