1111411111
1     11 1
1 21   1 1
1 311111 1
1        1
1  3221111
12 1  1  1
12 21 1 21
1 tP g   1
1    41 11
1 s  4   1
1    4   1
1142221111